########################
#~~~~~~~~~~~~~~~~~~~~~~#
#~~~~~~~~~~~~~~~~~~~~~~#
#~~~~~~~~~~~~~~~~~~~~~~#
#~~~~~~~~~~~~~~~~~~~~~~#
#~~~~~~~~~~~~~~~~~~~~~~#
#~~~~~~~~~~~~~~~~~~~~~~#
#~~~~~~888~~~888~~~~~~~#
#~~~~~~8~~~~~~~8~~~~~~~#
#~~~~~~~~~~~~~~~~~~~~~~#
#~~~~~~~~~~~~~~~~~~~~~~#
#~~~~~~8~~~~~~~8~~~~~~~#
#~~~~~~888888888~~~~~~~#
#~~~~~~~~~~~~~~~~~~~~~~#
#~~~~~~~~~~~~~~~~~~~~~~#
########################